0	1	2	3	4	5	6	7	8	9	10	11	12
0	0	1	0	1	0	0	1	0	0	0	0	0	0
1	1	0	1	1	1	0	0	0	0	0	0	0	0
2	0	1	0	0	1	1	0	0	0	0	0	0	0
3	1	1	0	0	1	0	1	1	0	0	0	0	0
4	0	1	1	1	0	1	0	1	1	0	0	0	0
5	0	0	1	0	1	0	0	0	1	0	0	1	0
6	1	0	0	1	0	0	0	1	0	1	0	0	0
7	0	0	0	1	1	0	1	0	1	1	0	0	0
8	0	0	0	0	1	1	0	1	0	0	1	1	0
9	0	0	0	0	0	0	1	1	0	0	1	0	0
10	0	0	0	0	0	0	0	1	1	1	0	1	1
11	0	0	0	0	0	1	0	0	1	0	1	0	1
12	0	0	0	0	0	0	0	0	0	0	1	1	0
$
1	0	2	2	0	1	0	0	2	2	1	0	2
